"tahun","bulan","mode","jarak","ongkir","belanja","total biaya","driver id","driver name","driver gender"
"2019","3","BIKE","5.55","2500","0","2500","90","Rusman Situmorang","L"
"2019","3","FOOD","7.08","9000","82000","91000","77","Lukman Ganep Januar M.Ak","L"
"2019","3","SHOP","4.02","5000","58500","63500","75","Atma Dasa Uwais","L"
"2019","3","FOOD","8.94","12000","72000","84000","82","Latif Marbun","L"
"2019","3","CAR","7.93","14400","0","14400","109","Maimunah Pudjiastuti","P"
"2019","3","BIKE","7.35","3500","0","3500","76","Paiman Wacana S.Kom","L"
"2019","3","BIKE","8.24","4000","0","4000","85","Jarwadi Nababan","L"
"2019","3","CAR","5.97","10800","0","10800","108","Ana Maimunah Pertiwi S.H.","P"
"2019","3","CAR","10.89","21600","0","21600","108","Ana Maimunah Pertiwi S.H.","P"
"2019","3","BIKE","4.1","1500","0","1500","86","Daliono Firgantoro","L"
"2019","3","BIKE","14.47","7500","0","7500","85","Jarwadi Nababan","L"
"2019","3","SHOP","9.65","13000","31000","44000","77","Lukman Ganep Januar M.Ak","L"
"2019","3","SHOP","4.85","6000","36000","42000","84","Lukita Napitupulu","L"
"2019","3","BIKE","11.3","5500","0","5500","86","Daliono Firgantoro","L"
"2019","3","CAR","3.79","6000","0","6000","108","Ana Maimunah Pertiwi S.H.","P"
"2019","3","BIKE","2.95","1000","0","1000","104","Faizah Shania Usamah S.T.","P"
"2019","3","CAR","10.02","19200","0","19200","109","Maimunah Pudjiastuti","P"
"2019","3","BIKE","2.44","1000","0","1000","81","Manah Sirait","L"
"2019","3","FOOD","5.97","7000","71500","78500","101","Kartika Winarsih S.Ked","P"
"2019","3","CAR","9.95","19200","0","19200","108","Ana Maimunah Pertiwi S.H.","P"
"2019","3","SHOP","5.7","7000","69500","76500","85","Jarwadi Nababan","L"
"2019","3","BIKE","7.08","3500","0","3500","83","Gaiman Hidayat S.Kom","L"
"2019","3","BIKE","4.98","2000","0","2000","101","Kartika Winarsih S.Ked","P"
"2019","3","CAR","4.58","7200","0","7200","109","Maimunah Pudjiastuti","P"
"2019","3","BIKE","5.89","2500","0","2500","81","Manah Sirait","L"
"2019","3","FOOD","5.22","6000","69000","75000","103","Eka Tira Haryanti","P"
"2019","3","CAR","9.99","19200","0","19200","108","Ana Maimunah Pertiwi S.H.","P"
"2019","3","CAR","3.65","6000","0","6000","97","Waluyo Setiawan","L"
"2019","3","FOOD","7.74","10000","49000","59000","85","Jarwadi Nababan","L"
"2019","3","BIKE","3.83","1500","0","1500","86","Daliono Firgantoro","L"
"2019","3","CAR","7.16","13200","0","13200","97","Waluyo Setiawan","L"
"2019","3","CAR","3.39","4800","0","4800","96","Bakda Gunawan","L"
"2019","3","CAR","3.2","4800","0","4800","95","Cengkal Marpaung","L"
"2019","3","FOOD","5.99","7000","28500","35500","76","Paiman Wacana S.Kom","L"
"2019","3","FOOD","4.75","6000","80000","86000","83","Gaiman Hidayat S.Kom","L"
"2019","3","BIKE","5.18","2500","0","2500","86","Daliono Firgantoro","L"
"2019","3","BIKE","4.76","2000","0","2000","92","Danu Januar","L"
"2019","3","FOOD","6.58","8000","54000","62000","90","Rusman Situmorang","L"
"2019","2","BIKE","3.62","1500","0","1500","90","Rusman Situmorang","L"
"2019","2","BIKE","6.01","3000","0","3000","76","Paiman Wacana S.Kom","L"
"2019","2","SHOP","10.6","14000","52500","66500","102","Intan Nasyiah","P"
"2019","2","BIKE","12.65","6500","0","6500","90","Rusman Situmorang","L"
"2019","2","FOOD","10.84","15000","53500","68500","81","Manah Sirait","L"
"2019","2","FOOD","6.27","8000","35000","43000","89","Dirja Mansur","L"
"2019","2","FOOD","4.06","5000","63500","68500","106","Yunita Laras Pratiwi","P"
"2019","2","FOOD","10.59","14000","32500","46500","102","Intan Nasyiah","P"
"2019","2","CAR","8.51","16800","0","16800","96","Bakda Gunawan","L"
"2019","2","FOOD","4.16","5000","94500","99500","79","Jabal Prasetya S.Psi","L"
"2019","2","BIKE","7.39","3500","0","3500","87","Artanto Eman Wacana S.I.Kom","L"
"2019","2","BIKE","8.23","4000","0","4000","102","Intan Nasyiah","P"
"2019","2","BIKE","8.13","4000","0","4000","106","Yunita Laras Pratiwi","P"
"2019","2","BIKE","7.28","3500","0","3500","105","Restu Yuniar S.Pt","P"
"2019","2","BIKE","6.04","3000","0","3000","78","Maryadi Natsir","L"
"2019","2","BIKE","11.75","6000","0","6000","78","Maryadi Natsir","L"
"2019","2","SHOP","3.07","3000","98500","101500","82","Latif Marbun","L"
"2019","2","FOOD","3.17","3000","64000","67000","76","Paiman Wacana S.Kom","L"
"2019","2","BIKE","10.07","5000","0","5000","93","Mahesa Tarihoran S.Farm","L"
"2019","2","CAR","3.52","6000","0","6000","109","Maimunah Pudjiastuti","P"
"2019","2","CAR","10.09","19200","0","19200","99","Joko Situmorang","L"
"2019","2","FOOD","6.25","8000","49000","57000","105","Restu Yuniar S.Pt","P"
"2019","2","BIKE","6.18","3000","0","3000","90","Rusman Situmorang","L"
"2019","2","FOOD","6.23","8000","86000","94000","75","Atma Dasa Uwais","L"
"2019","2","SHOP","10.68","15000","42000","57000","91","Margana Pratama","L"
"2019","2","BIKE","6.97","3500","0","3500","104","Faizah Shania Usamah S.T.","P"
"2019","2","FOOD","4.67","6000","42000","48000","101","Kartika Winarsih S.Ked","P"
"2019","2","CAR","5.38","9600","0","9600","107","Gasti Nadia Pratiwi S.Gz","P"
"2019","2","FOOD","5.5","7000","47500","54500","76","Paiman Wacana S.Kom","L"
"2019","2","CAR","12.63","25200","0","25200","98","Imam Abyasa Maheswara","L"
"2019","2","BIKE","6.12","3000","0","3000","85","Jarwadi Nababan","L"
"2019","2","SHOP","6.12","8000","60500","68500","101","Kartika Winarsih S.Ked","P"
"2019","2","BIKE","2.95","1000","0","1000","80","Mursita Prasetya","L"
"2019","2","BIKE","11.66","6000","0","6000","78","Maryadi Natsir","L"
"2019","2","BIKE","5.9","2500","0","2500","92","Danu Januar","L"
"2019","2","SHOP","12.24","17000","100000","117000","89","Dirja Mansur","L"
"2019","2","FOOD","9.64","13000","32500","45500","77","Lukman Ganep Januar M.Ak","L"
"2019","2","BIKE","10.45","5000","0","5000","93","Mahesa Tarihoran S.Farm","L"
"2019","2","SHOP","8.46","11000","34500","45500","81","Manah Sirait","L"
"2019","2","CAR","7.81","14400","0","14400","108","Ana Maimunah Pertiwi S.H.","P"
"2019","2","CAR","14.26","28800","0","28800","97","Waluyo Setiawan","L"
"2019","2","FOOD","2.76","3000","81500","84500","104","Faizah Shania Usamah S.T.","P"
"2019","2","FOOD","8.48","11000","96000","107000","75","Atma Dasa Uwais","L"
"2019","2","CAR","10.05","19200","0","19200","99","Joko Situmorang","L"
"2019","2","BIKE","4.18","1500","0","1500","77","Lukman Ganep Januar M.Ak","L"
"2019","2","BIKE","10.52","5000","0","5000","100","Halima Kani Purnawati","P"
"2019","2","BIKE","9.51","4500","0","4500","80","Mursita Prasetya","L"
"2019","2","CAR","5.59","9600","0","9600","96","Bakda Gunawan","L"
"2019","2","BIKE","6.53","3000","0","3000","88","Jatmiko Waluyo S.Pd","L"
"2019","2","CAR","5.85","10800","0","10800","98","Imam Abyasa Maheswara","L"
"2019","2","FOOD","4.93","6000","56000","62000","105","Restu Yuniar S.Pt","P"
"2019","2","FOOD","2.82","3000","47500","50500","79","Jabal Prasetya S.Psi","L"
"2019","2","SHOP","3","3000","76000","79000","83","Gaiman Hidayat S.Kom","L"
"2019","2","BIKE","5.3","2500","0","2500","80","Mursita Prasetya","L"
"2019","2","FOOD","5.95","7000","60500","67500","81","Manah Sirait","L"
"2019","2","CAR","6.65","12000","0","12000","99","Joko Situmorang","L"
"2019","2","SHOP","5.68","7000","31000","38000","80","Mursita Prasetya","L"
"2019","2","BIKE","7.47","3500","0","3500","91","Margana Pratama","L"
"2019","2","FOOD","7.88","10000","98500","108500","104","Faizah Shania Usamah S.T.","P"
"2019","2","BIKE","6.69","3000","0","3000","100","Halima Kani Purnawati","P"
"2019","2","BIKE","5.67","2500","0","2500","78","Maryadi Natsir","L"
"2019","2","BIKE","5.89","2500","0","2500","75","Atma Dasa Uwais","L"
"2019","2","BIKE","7.09","3500","0","3500","101","Kartika Winarsih S.Ked","P"
"2019","2","BIKE","10.54","5000","0","5000","83","Gaiman Hidayat S.Kom","L"
"2019","2","SHOP","4.99","6000","63000","69000","78","Maryadi Natsir","L"
"2019","2","FOOD","4.21","5000","60000","65000","90","Rusman Situmorang","L"
"2019","2","BIKE","7.13","3500","0","3500","94","Harjo Karya Suwarno","L"
"2019","2","FOOD","11.01","15000","80500","95500","83","Gaiman Hidayat S.Kom","L"
"2019","2","BIKE","7.21","3500","0","3500","90","Rusman Situmorang","L"
"2019","2","BIKE","8.23","4000","0","4000","78","Maryadi Natsir","L"
"2019","2","BIKE","8","4000","0","4000","88","Jatmiko Waluyo S.Pd","L"
"2019","2","FOOD","3.12","3000","62000","65000","83","Gaiman Hidayat S.Kom","L"
"2019","2","BIKE","7.68","3500","0","3500","82","Latif Marbun","L"
"2019","2","BIKE","12.21","6000","0","6000","94","Harjo Karya Suwarno","L"
"2019","2","BIKE","9.55","4500","0","4500","93","Mahesa Tarihoran S.Farm","L"
"2019","2","FOOD","4.89","6000","84500","90500","76","Paiman Wacana S.Kom","L"
"2019","2","BIKE","5.23","2500","0","2500","94","Harjo Karya Suwarno","L"
"2019","2","CAR","12.65","25200","0","25200","99","Joko Situmorang","L"
"2019","2","BIKE","13.76","7000","0","7000","101","Kartika Winarsih S.Ked","P"
"2019","2","BIKE","8.35","4000","0","4000","80","Mursita Prasetya","L"
"2019","2","BIKE","4.55","2000","0","2000","92","Danu Januar","L"
"2019","2","SHOP","5.77","7000","46500","53500","82","Latif Marbun","L"
"2019","2","FOOD","4.77","6000","30500","36500","94","Harjo Karya Suwarno","L"
"2019","2","CAR","3.95","6000","0","6000","97","Waluyo Setiawan","L"
"2019","2","BIKE","4.63","2000","0","2000","101","Kartika Winarsih S.Ked","P"
"2019","2","BIKE","11.64","6000","0","6000","79","Jabal Prasetya S.Psi","L"
"2019","2","CAR","6.66","12000","0","12000","109","Maimunah Pudjiastuti","P"
"2019","2","BIKE","7.46","3500","0","3500","104","Faizah Shania Usamah S.T.","P"
"2019","2","SHOP","8.18","11000","78500","89500","79","Jabal Prasetya S.Psi","L"
"2019","2","FOOD","7.43","10000","72500","82500","87","Artanto Eman Wacana S.I.Kom","L"
"2019","2","BIKE","15.21","8000","0","8000","80","Mursita Prasetya","L"
"2019","2","SHOP","6.93","9000","41000","50000","91","Margana Pratama","L"
"2019","2","FOOD","4.18","5000","26500","31500","83","Gaiman Hidayat S.Kom","L"
"2019","2","SHOP","4","5000","91000","96000","90","Rusman Situmorang","L"
"2019","2","BIKE","11.96","6000","0","6000","78","Maryadi Natsir","L"
"2019","2","SHOP","4.32","5000","34000","39000","103","Eka Tira Haryanti","P"
"2019","2","CAR","10.5","20400","0","20400","98","Imam Abyasa Maheswara","L"
"2019","2","CAR","6.14","10800","0","10800","109","Maimunah Pudjiastuti","P"
"2019","2","CAR","4","6000","0","6000","109","Maimunah Pudjiastuti","P"
"2019","2","CAR","4.6","7200","0","7200","109","Maimunah Pudjiastuti","P"
"2019","1","BIKE","6.82","3000","0","3000","93","Mahesa Tarihoran S.Farm","L"
"2019","1","FOOD","3.57","4000","81500","85500","86","Daliono Firgantoro","L"
"2019","1","CAR","7.59","14400","0","14400","97","Waluyo Setiawan","L"
"2019","1","FOOD","7.33","9000","68000","77000","85","Jarwadi Nababan","L"
"2019","1","FOOD","5.25","6000","91500","97500","83","Gaiman Hidayat S.Kom","L"
"2019","1","CAR","5.38","9600","0","9600","99","Joko Situmorang","L"
"2019","1","BIKE","10.61","5500","0","5500","91","Margana Pratama","L"
"2019","1","FOOD","5.94","7000","78000","85000","101","Kartika Winarsih S.Ked","P"
"2019","1","FOOD","6.15","8000","31500","39500","91","Margana Pratama","L"
"2019","1","FOOD","5.12","6000","92500","98500","94","Harjo Karya Suwarno","L"
"2019","1","FOOD","4.41","5000","73500","78500","85","Jarwadi Nababan","L"
"2019","1","BIKE","13.15","6500","0","6500","77","Lukman Ganep Januar M.Ak","L"
"2019","1","BIKE","13.65","7000","0","7000","77","Lukman Ganep Januar M.Ak","L"
"2019","1","BIKE","10.3","5000","0","5000","93","Mahesa Tarihoran S.Farm","L"
"2019","1","FOOD","3.44","4000","66500","70500","103","Eka Tira Haryanti","P"
"2019","1","CAR","4.77","8400","0","8400","107","Gasti Nadia Pratiwi S.Gz","P"
"2019","1","BIKE","8.5","4000","0","4000","106","Yunita Laras Pratiwi","P"
"2019","1","BIKE","8.67","4000","0","4000","102","Intan Nasyiah","P"
"2019","1","BIKE","7.02","3500","0","3500","100","Halima Kani Purnawati","P"
"2019","1","SHOP","5.58","7000","55500","62500","81","Manah Sirait","L"
"2019","1","FOOD","4.48","5000","43500","48500","75","Atma Dasa Uwais","L"
"2019","1","BIKE","7.95","4000","0","4000","91","Margana Pratama","L"
"2019","1","FOOD","4.97","6000","99000","105000","84","Lukita Napitupulu","L"
"2019","1","CAR","7.18","13200","0","13200","99","Joko Situmorang","L"
"2019","1","BIKE","16.58","8500","0","8500","86","Daliono Firgantoro","L"
"2019","1","BIKE","7.96","4000","0","4000","104","Faizah Shania Usamah S.T.","P"
"2019","1","FOOD","6.2","8000","36000","44000","93","Mahesa Tarihoran S.Farm","L"
"2019","1","CAR","7.78","14400","0","14400","108","Ana Maimunah Pertiwi S.H.","P"
"2019","1","BIKE","6.12","3000","0","3000","105","Restu Yuniar S.Pt","P"
"2019","1","CAR","9.15","18000","0","18000","97","Waluyo Setiawan","L"
"2019","1","FOOD","6.09","8000","59000","67000","104","Faizah Shania Usamah S.T.","P"
"2019","1","BIKE","7.76","3500","0","3500","88","Jatmiko Waluyo S.Pd","L"
"2019","1","BIKE","12.19","6000","0","6000","80","Mursita Prasetya","L"
"2019","1","CAR","6.62","12000","0","12000","109","Maimunah Pudjiastuti","P"
"2019","1","CAR","4.05","6000","0","6000","109","Maimunah Pudjiastuti","P"
"2019","1","BIKE","7.26","3500","0","3500","90","Rusman Situmorang","L"
"2019","1","CAR","12.89","25200","0","25200","97","Waluyo Setiawan","L"
"2019","1","SHOP","3.6","4000","58500","62500","89","Dirja Mansur","L"
"2019","1","CAR","9.52","18000","0","18000","99","Joko Situmorang","L"
"2019","1","FOOD","8.57","11000","51000","62000","88","Jatmiko Waluyo S.Pd","L"
"2019","1","FOOD","6.76","9000","87000","96000","94","Harjo Karya Suwarno","L"
"2019","1","CAR","11.32","22800","0","22800","108","Ana Maimunah Pertiwi S.H.","P"
"2019","1","BIKE","7","3500","0","3500","104","Faizah Shania Usamah S.T.","P"
"2019","1","SHOP","5.28","6000","25500","31500","91","Margana Pratama","L"
"2019","1","BIKE","7.16","3500","0","3500","78","Maryadi Natsir","L"
"2019","1","FOOD","2.98","3000","86500","89500","80","Mursita Prasetya","L"
"2019","1","CAR","13.5","27600","0","27600","97","Waluyo Setiawan","L"
"2019","1","CAR","5.55","9600","0","9600","108","Ana Maimunah Pertiwi S.H.","P"
"2019","1","BIKE","10.25","5000","0","5000","92","Danu Januar","L"
"2019","1","CAR","5.09","8400","0","8400","96","Bakda Gunawan","L"
"2019","1","SHOP","5.72","7000","39000","46000","89","Dirja Mansur","L"
"2019","1","FOOD","4.21","5000","62500","67500","88","Jatmiko Waluyo S.Pd","L"
"2019","1","SHOP","5.73","7000","85500","92500","92","Danu Januar","L"
"2019","1","BIKE","12.1","6000","0","6000","94","Harjo Karya Suwarno","L"
"2019","1","SHOP","10.92","15000","70500","85500","89","Dirja Mansur","L"
"2019","1","CAR","6.74","12000","0","12000","97","Waluyo Setiawan","L"
"2019","1","CAR","5.84","10800","0","10800","99","Joko Situmorang","L"
"2019","1","FOOD","6.96","9000","73000","82000","88","Jatmiko Waluyo S.Pd","L"
"2019","1","CAR","4.35","7200","0","7200","99","Joko Situmorang","L"
"2019","1","BIKE","9.87","5000","0","5000","89","Dirja Mansur","L"
"2019","1","CAR","12.64","25200","0","25200","99","Joko Situmorang","L"
"2019","1","SHOP","6.21","8000","66500","74500","77","Lukman Ganep Januar M.Ak","L"
"2019","1","BIKE","3.13","1000","0","1000","106","Yunita Laras Pratiwi","P"
"2019","1","CAR","8.27","15600","0","15600","97","Waluyo Setiawan","L"
"2019","1","BIKE","10.29","5000","0","5000","93","Mahesa Tarihoran S.Farm","L"
"2019","1","SHOP","6.16","8000","69000","77000","87","Artanto Eman Wacana S.I.Kom","L"
"2019","1","BIKE","7.87","4000","0","4000","102","Intan Nasyiah","P"
"2019","1","CAR","3.04","4800","0","4800","97","Waluyo Setiawan","L"
"2019","1","FOOD","8.97","12000","89500","101500","87","Artanto Eman Wacana S.I.Kom","L"
"2019","1","FOOD","6.19","8000","46500","54500","101","Kartika Winarsih S.Ked","P"
"2019","1","CAR","10.21","20400","0","20400","97","Waluyo Setiawan","L"
"2019","1","SHOP","7.5","10000","58000","68000","76","Paiman Wacana S.Kom","L"
"2019","1","CAR","4.88","8400","0","8400","95","Cengkal Marpaung","L"
"2019","1","CAR","13.8","27600","0","27600","109","Maimunah Pudjiastuti","P"
"2019","1","FOOD","5.96","7000","99000","106000","100","Halima Kani Purnawati","P"
"2019","1","CAR","3.15","4800","0","4800","96","Bakda Gunawan","L"
"2019","1","FOOD","6.12","8000","75500","83500","104","Faizah Shania Usamah S.T.","P"
"2019","1","SHOP","3.55","4000","99000","103000","106","Yunita Laras Pratiwi","P"
"2019","1","BIKE","8.13","4000","0","4000","103","Eka Tira Haryanti","P"
"2019","1","CAR","7.13","13200","0","13200","99","Joko Situmorang","L"
"2019","1","BIKE","9.59","4500","0","4500","106","Yunita Laras Pratiwi","P"
"2019","1","CAR","10.46","20400","0","20400","108","Ana Maimunah Pertiwi S.H.","P"
"2019","1","FOOD","12.94","18000","44000","62000","77","Lukman Ganep Januar M.Ak","L"
"2019","1","CAR","11.73","22800","0","22800","95","Cengkal Marpaung","L"
"2019","1","FOOD","3.92","4000","90500","94500","104","Faizah Shania Usamah S.T.","P"
"2019","1","SHOP","4.59","5000","77000","82000","101","Kartika Winarsih S.Ked","P"
"2019","1","FOOD","9.61","13000","93500","106500","79","Jabal Prasetya S.Psi","L"
"2019","1","BIKE","5.43","2500","0","2500","87","Artanto Eman Wacana S.I.Kom","L"
"2019","1","FOOD","7.19","9000","32500","41500","92","Danu Januar","L"
"2019","1","BIKE","5.86","2500","0","2500","75","Atma Dasa Uwais","L"
"2019","1","BIKE","5.79","2500","0","2500","92","Danu Januar","L"
"2019","1","SHOP","4.43","5000","56500","61500","100","Halima Kani Purnawati","P"
"2019","1","BIKE","3.33","1500","0","1500","87","Artanto Eman Wacana S.I.Kom","L"
"2019","1","BIKE","9.18","4500","0","4500","81","Manah Sirait","L"
"2019","1","BIKE","4.41","2000","0","2000","83","Gaiman Hidayat S.Kom","L"
"2019","1","SHOP","4.81","6000","29500","35500","105","Restu Yuniar S.Pt","P"
"2019","1","BIKE","6.65","3000","0","3000","82","Latif Marbun","L"
"2019","1","CAR","9.96","19200","0","19200","108","Ana Maimunah Pertiwi S.H.","P"
"2019","1","BIKE","6.42","3000","0","3000","92","Danu Januar","L"
"2019","1","FOOD","5.41","7000","40000","47000","88","Jatmiko Waluyo S.Pd","L"
"2019","1","BIKE","8.94","4500","0","4500","79","Jabal Prasetya S.Psi","L"
"2019","1","BIKE","6.06","3000","0","3000","93","Mahesa Tarihoran S.Farm","L"
"2019","1","FOOD","7.94","10000","99500","109500","82","Latif Marbun","L"
"2019","1","CAR","5.43","9600","0","9600","98","Imam Abyasa Maheswara","L"
"2019","1","CAR","3.74","6000","0","6000","97","Waluyo Setiawan","L"
"2019","1","SHOP","5.73","7000","49000","56000","93","Mahesa Tarihoran S.Farm","L"
"2019","1","FOOD","6.49","8000","84500","92500","80","Mursita Prasetya","L"
"2019","1","CAR","5.55","9600","0","9600","109","Maimunah Pudjiastuti","P"
"2019","1","BIKE","10.28","5000","0","5000","105","Restu Yuniar S.Pt","P"
"2019","1","BIKE","2.79","1000","0","1000","91","Margana Pratama","L"
"2019","1","BIKE","6.33","3000","0","3000","105","Restu Yuniar S.Pt","P"
"2019","1","BIKE","7.65","3500","0","3500","84","Lukita Napitupulu","L"
"2019","1","BIKE","10.1","5000","0","5000","86","Daliono Firgantoro","L"
"2019","1","CAR","13.64","27600","0","27600","99","Joko Situmorang","L"
"2019","1","BIKE","9.14","4500","0","4500","102","Intan Nasyiah","P"
"2019","1","SHOP","5.74","7000","61500","68500","100","Halima Kani Purnawati","P"
"2019","1","FOOD","11.77","16000","49500","65500","100","Halima Kani Purnawati","P"
"2019","1","CAR","2.6","3600","0","3600","107","Gasti Nadia Pratiwi S.Gz","P"
"2019","1","CAR","8","15600","0","15600","96","Bakda Gunawan","L"
"2019","1","FOOD","4.88","6000","32500","38500","78","Maryadi Natsir","L"
"2019","1","FOOD","760.4","1000","75000","76000","75","Atma Dasa Uwais","L"
"2019","1","CAR","4.43","7200","0","7200","107","Gasti Nadia Pratiwi S.Gz","P"
"2019","1","BIKE","5.19","2500","0","2500","81","Manah Sirait","L"
"2019","1","BIKE","12.98","6500","0","6500","101","Kartika Winarsih S.Ked","P"
"2019","1","CAR","6.83","12000","0","12000","98","Imam Abyasa Maheswara","L"
"2019","1","SHOP","4.44","5000","54000","59000","85","Jarwadi Nababan","L"
"2019","1","SHOP","5.57","7000","59000","66000","94","Harjo Karya Suwarno","L"
"2019","1","BIKE","10.57","5500","0","5500","90","Rusman Situmorang","L"
"2018","12","BIKE","6.22","3000","0","3000","83","Gaiman Hidayat S.Kom","L"
"2018","12","SHOP","9.93","13000","95500","108500","76","Paiman Wacana S.Kom","L"
"2018","12","FOOD","5.25","6000","31000","37000","83","Gaiman Hidayat S.Kom","L"
"2018","12","CAR","11.46","22800","0","22800","108","Ana Maimunah Pertiwi S.H.","P"
"2018","12","BIKE","8.15","4000","0","4000","76","Paiman Wacana S.Kom","L"
"2018","12","BIKE","8.4","4000","0","4000","83","Gaiman Hidayat S.Kom","L"
"2018","12","CAR","5.5","9600","0","9600","109","Maimunah Pudjiastuti","P"
"2018","12","CAR","9.87","19200","0","19200","107","Gasti Nadia Pratiwi S.Gz","P"
"2018","12","BIKE","4.99","2000","0","2000","91","Margana Pratama","L"
"2018","12","BIKE","7.63","3500","0","3500","85","Jarwadi Nababan","L"
"2018","12","FOOD","2.17","2000","75500","77500","83","Gaiman Hidayat S.Kom","L"
"2018","12","FOOD","8.82","12000","27000","39000","83","Gaiman Hidayat S.Kom","L"
"2018","12","CAR","11.82","22800","0","22800","107","Gasti Nadia Pratiwi S.Gz","P"
"2018","12","SHOP","4.08","5000","43500","48500","81","Manah Sirait","L"
"2018","12","FOOD","8.42","11000","54000","65000","103","Eka Tira Haryanti","P"
"2018","12","FOOD","8","11000","93000","104000","102","Intan Nasyiah","P"
"2018","12","CAR","10.25","20400","0","20400","98","Imam Abyasa Maheswara","L"
"2018","12","FOOD","6.35","8000","48500","56500","87","Artanto Eman Wacana S.I.Kom","L"
"2018","12","CAR","12.94","25200","0","25200","95","Cengkal Marpaung","L"
"2018","12","SHOP","8.9","12000","56500","68500","85","Jarwadi Nababan","L"
"2018","12","SHOP","5.7","7000","87000","94000","78","Maryadi Natsir","L"
"2018","12","CAR","8.52","16800","0","16800","108","Ana Maimunah Pertiwi S.H.","P"
"2018","12","BIKE","6.84","3000","0","3000","100","Halima Kani Purnawati","P"
"2018","12","FOOD","6.11","8000","33500","41500","79","Jabal Prasetya S.Psi","L"
"2018","12","BIKE","4.82","2000","0","2000","87","Artanto Eman Wacana S.I.Kom","L"
"2018","12","FOOD","8.35","11000","45500","56500","81","Manah Sirait","L"
"2018","12","SHOP","6.44","8000","42500","50500","78","Maryadi Natsir","L"
"2018","12","FOOD","5.32","6000","40000","46000","104","Faizah Shania Usamah S.T.","P"
"2018","12","CAR","3.23","4800","0","4800","98","Imam Abyasa Maheswara","L"
"2018","12","FOOD","7.09","9000","78000","87000","104","Faizah Shania Usamah S.T.","P"
"2018","12","SHOP","6.05","8000","56000","64000","87","Artanto Eman Wacana S.I.Kom","L"
"2018","12","FOOD","11.07","15000","25500","40500","75","Atma Dasa Uwais","L"
"2018","12","SHOP","5.39","7000","53500","60500","80","Mursita Prasetya","L"
"2018","12","FOOD","7.66","10000","86500","96500","88","Jatmiko Waluyo S.Pd","L"
"2018","12","CAR","4.75","8400","0","8400","97","Waluyo Setiawan","L"
"2018","12","FOOD","10.37","14000","44500","58500","93","Mahesa Tarihoran S.Farm","L"
"2018","12","FOOD","5.3","6000","86000","92000","102","Intan Nasyiah","P"
"2018","12","CAR","3.96","6000","0","6000","108","Ana Maimunah Pertiwi S.H.","P"
"2018","12","FOOD","7.93","10000","47000","57000","94","Harjo Karya Suwarno","L"
"2018","12","CAR","12.45","25200","0","25200","108","Ana Maimunah Pertiwi S.H.","P"
"2018","12","SHOP","9.61","13000","97000","110000","85","Jarwadi Nababan","L"
"2018","12","FOOD","5.79","7000","35500","42500","83","Gaiman Hidayat S.Kom","L"
"2018","12","FOOD","5.05","6000","33000","39000","94","Harjo Karya Suwarno","L"
"2018","12","CAR","5.74","10800","0","10800","97","Waluyo Setiawan","L"
"2018","12","FOOD","13.61","19000","82000","101000","89","Dirja Mansur","L"
"2018","12","SHOP","8.28","11000","55500","66500","105","Restu Yuniar S.Pt","P"
"2018","12","CAR","5.54","9600","0","9600","98","Imam Abyasa Maheswara","L"
"2018","12","SHOP","7.79","10000","91500","101500","86","Daliono Firgantoro","L"
"2018","12","SHOP","5.29","6000","69500","75500","94","Harjo Karya Suwarno","L"
"2018","12","SHOP","3.66","4000","100000","104000","91","Margana Pratama","L"
"2018","12","SHOP","6.77","9000","63500","72500","78","Maryadi Natsir","L"
"2018","12","FOOD","11.33","15000","99000","114000","86","Daliono Firgantoro","L"
"2018","12","CAR","8.09","15600","0","15600","96","Bakda Gunawan","L"
"2018","12","SHOP","3.38","4000","96000","100000","101","Kartika Winarsih S.Ked","P"
"2018","12","CAR","4.32","7200","0","7200","99","Joko Situmorang","L"
"2018","12","CAR","10.73","21600","0","21600","99","Joko Situmorang","L"
"2018","12","CAR","9.4","18000","0","18000","96","Bakda Gunawan","L"
"2018","12","FOOD","6.41","8000","35000","43000","104","Faizah Shania Usamah S.T.","P"
"2018","12","CAR","4.2","7200","0","7200","109","Maimunah Pudjiastuti","P"
"2018","12","SHOP","3.5","4000","41000","45000","93","Mahesa Tarihoran S.Farm","L"
"2018","12","SHOP","11.65","16000","87500","103500","77","Lukman Ganep Januar M.Ak","L"
"2018","12","CAR","4.79","8400","0","8400","96","Bakda Gunawan","L"
"2018","12","BIKE","8.04","4000","0","4000","85","Jarwadi Nababan","L"
"2018","12","CAR","9.89","19200","0","19200","108","Ana Maimunah Pertiwi S.H.","P"
"2018","12","SHOP","4.44","5000","71000","76000","88","Jatmiko Waluyo S.Pd","L"
"2018","12","FOOD","10.99","15000","68500","83500","76","Paiman Wacana S.Kom","L"
"2018","12","CAR","9.78","19200","0","19200","95","Cengkal Marpaung","L"
"2018","12","FOOD","8.77","12000","94500","106500","89","Dirja Mansur","L"
"2018","12","CAR","9.52","18000","0","18000","96","Bakda Gunawan","L"
"2018","12","SHOP","11.06","15000","89500","104500","81","Manah Sirait","L"
"2018","12","CAR","7.46","14400","0","14400","96","Bakda Gunawan","L"
"2018","12","SHOP","9.89","13000","53500","66500","93","Mahesa Tarihoran S.Farm","L"
"2018","12","SHOP","4.24","5000","75000","80000","80","Mursita Prasetya","L"
"2018","12","CAR","11.17","21600","0","21600","108","Ana Maimunah Pertiwi S.H.","P"
"2018","12","FOOD","5.71","7000","30500","37500","78","Maryadi Natsir","L"
"2018","12","FOOD","4.31","5000","47000","52000","78","Maryadi Natsir","L"
"2018","12","SHOP","4.07","5000","80500","85500","88","Jatmiko Waluyo S.Pd","L"
"2018","12","SHOP","7.57","10000","47000","57000","102","Intan Nasyiah","P"
"2018","12","SHOP","7.99","10000","68500","78500","105","Restu Yuniar S.Pt","P"
"2018","12","SHOP","3.77","4000","60500","64500","81","Manah Sirait","L"
"2018","12","SHOP","6.63","8000","44000","52000","86","Daliono Firgantoro","L"
"2018","12","FOOD","8.74","12000","66000","78000","84","Lukita Napitupulu","L"
"2018","12","BIKE","7.63","3500","0","3500","79","Jabal Prasetya S.Psi","L"
"2018","12","CAR","7.97","15600","0","15600","95","Cengkal Marpaung","L"
"2018","12","CAR","8.33","15600","0","15600","109","Maimunah Pudjiastuti","P"
"2018","12","CAR","7.3","13200","0","13200","99","Joko Situmorang","L"
"2018","12","FOOD","7.96","10000","82500","92500","104","Faizah Shania Usamah S.T.","P"
"2018","12","FOOD","4.42","5000","60000","65000","91","Margana Pratama","L"
"2018","12","SHOP","4.61","5000","71000","76000","76","Paiman Wacana S.Kom","L"
"2018","12","SHOP","9.4","13000","68500","81500","84","Lukita Napitupulu","L"
"2018","12","FOOD","5.22","6000","51500","57500","87","Artanto Eman Wacana S.I.Kom","L"
"2018","12","SHOP","11","15000","46500","61500","89","Dirja Mansur","L"
"2018","12","SHOP","8.03","11000","82000","93000","104","Faizah Shania Usamah S.T.","P"
"2018","12","BIKE","8.63","4000","0","4000","100","Halima Kani Purnawati","P"
"2018","12","FOOD","6.6","8000","76500","84500","79","Jabal Prasetya S.Psi","L"
"2018","12","CAR","3.76","6000","0","6000","96","Bakda Gunawan","L"
"2018","12","FOOD","7.43","10000","49000","59000","80","Mursita Prasetya","L"
"2018","12","SHOP","5.98","7000","32000","39000","75","Atma Dasa Uwais","L"
"2018","12","CAR","15.9","32400","0","32400","98","Imam Abyasa Maheswara","L"
"2018","12","FOOD","10.65","14000","32000","46000","91","Margana Pratama","L"
"2018","12","CAR","9.68","19200","0","19200","95","Cengkal Marpaung","L"
"2018","12","SHOP","7.07","9000","59000","68000","81","Manah Sirait","L"
"2018","12","BIKE","6.73","3000","0","3000","92","Danu Januar","L"
"2018","12","CAR","13.26","26400","0","26400","99","Joko Situmorang","L"
"2018","12","SHOP","12.98","18000","70000","88000","92","Danu Januar","L"
"2018","12","FOOD","3.01","3000","62000","65000","91","Margana Pratama","L"
"2018","12","CAR","5.74","10800","0","10800","96","Bakda Gunawan","L"
"2018","12","FOOD","7.48","10000","60500","70500","89","Dirja Mansur","L"
"2018","12","CAR","8.87","16800","0","16800","99","Joko Situmorang","L"
"2018","12","FOOD","7.02","9000","86000","95000","78","Maryadi Natsir","L"
"2018","12","CAR","6.46","12000","0","12000","98","Imam Abyasa Maheswara","L"
"2018","12","CAR","10.09","19200","0","19200","96","Bakda Gunawan","L"
"2018","12","FOOD","6.64","8000","41500","49500","76","Paiman Wacana S.Kom","L"
"2018","12","CAR","6.82","12000","0","12000","108","Ana Maimunah Pertiwi S.H.","P"
"2018","12","CAR","12.77","25200","0","25200","96","Bakda Gunawan","L"
"2018","12","CAR","6.95","13200","0","13200","95","Cengkal Marpaung","L"
"2018","12","FOOD","8.06","11000","40500","51500","100","Halima Kani Purnawati","P"
"2018","12","SHOP","6.24","8000","66000","74000","79","Jabal Prasetya S.Psi","L"
"2018","12","FOOD","5.52","7000","43500","50500","94","Harjo Karya Suwarno","L"
"2018","12","SHOP","5.06","6000","82000","88000","94","Harjo Karya Suwarno","L"
"2018","12","SHOP","9.31","12000","40500","52500","102","Intan Nasyiah","P"
"2018","12","CAR","8.32","15600","0","15600","96","Bakda Gunawan","L"
"2019","1","FOOD","754.92","1000","88000","89000","103","Eka Tira Haryanti","P"
"2018","12","CAR","7.06","13200","0","13200","95","Cengkal Marpaung","L"
"2019","1","FOOD","757.95","1000","84500","85500","76","Paiman Wacana S.Kom","L"
"2018","12","SHOP","7.44","10000","26000","36000","100","Halima Kani Purnawati","P"
"2018","12","SHOP","8.19","11000","40500","51500","102","Intan Nasyiah","P"
"2018","12","CAR","8.11","15600","0","15600","109","Maimunah Pudjiastuti","P"
"2018","12","CAR","8.81","16800","0","16800","107","Gasti Nadia Pratiwi S.Gz","P"
"2018","12","SHOP","4.92","6000","42500","48500","85","Jarwadi Nababan","L"
"2018","12","FOOD","9.16","12000","57000","69000","75","Atma Dasa Uwais","L"
"2018","12","CAR","6.09","10800","0","10800","109","Maimunah Pudjiastuti","P"
"2018","12","SHOP","9.67","13000","95000","108000","100","Halima Kani Purnawati","P"
"2018","12","CAR","7.37","13200","0","13200","97","Waluyo Setiawan","L"
"2018","12","FOOD","9.47","13000","29000","42000","81","Manah Sirait","L"
"2018","12","BIKE","4.87","2000","0","2000","105","Restu Yuniar S.Pt","P"
"2018","12","SHOP","6.76","9000","86500","95500","90","Rusman Situmorang","L"
"2018","12","FOOD","6.8","9000","37000","46000","106","Yunita Laras Pratiwi","P"
"2018","12","SHOP","4.32","5000","36500","41500","91","Margana Pratama","L"
"2018","12","SHOP","8.06","11000","84000","95000","105","Restu Yuniar S.Pt","P"
"2018","12","CAR","10.01","19200","0","19200","99","Joko Situmorang","L"
"2018","12","SHOP","5.67","7000","67000","74000","101","Kartika Winarsih S.Ked","P"
"2018","12","CAR","10.59","20400","0","20400","95","Cengkal Marpaung","L"
"2018","12","FOOD","5.9","7000","86000","93000","103","Eka Tira Haryanti","P"
"2018","12","SHOP","6.37","8000","36000","44000","101","Kartika Winarsih S.Ked","P"
"2018","12","FOOD","8.69","12000","86500","98500","90","Rusman Situmorang","L"
"2018","12","CAR","4.66","8400","0","8400","99","Joko Situmorang","L"
"2018","12","FOOD","14.46","20000","94500","114500","78","Maryadi Natsir","L"
"2018","12","CAR","6.99","13200","0","13200","107","Gasti Nadia Pratiwi S.Gz","P"
"2018","12","CAR","5.9","10800","0","10800","109","Maimunah Pudjiastuti","P"
"2018","12","SHOP","7.93","10000","97500","107500","86","Daliono Firgantoro","L"
"2018","12","CAR","11.41","22800","0","22800","109","Maimunah Pudjiastuti","P"
"2018","12","CAR","7.91","14400","0","14400","95","Cengkal Marpaung","L"
"2018","12","CAR","8.34","15600","0","15600","96","Bakda Gunawan","L"
"2018","12","FOOD","10.68","15000","90000","105000","82","Latif Marbun","L"
"2018","12","CAR","2.78","3600","0","3600","109","Maimunah Pudjiastuti","P"
"2018","12","CAR","6.27","10800","0","10800","97","Waluyo Setiawan","L"
"2018","12","SHOP","5.98","7000","76500","83500","101","Kartika Winarsih S.Ked","P"
"2018","12","SHOP","13.3","18000","96000","114000","88","Jatmiko Waluyo S.Pd","L"
"2018","12","FOOD","6.64","8000","29000","37000","78","Maryadi Natsir","L"
"2018","12","CAR","2.51","3600","0","3600","107","Gasti Nadia Pratiwi S.Gz","P"
"2018","12","FOOD","6.56","8000","53500","61500","85","Jarwadi Nababan","L"
"2018","12","FOOD","10.8","15000","50500","65500","100","Halima Kani Purnawati","P"
"2018","12","FOOD","6.24","8000","59500","67500","83","Gaiman Hidayat S.Kom","L"
"2018","12","SHOP","4.75","6000","92500","98500","79","Jabal Prasetya S.Psi","L"
"2018","12","SHOP","8.84","12000","75500","87500","88","Jatmiko Waluyo S.Pd","L"
"2018","12","FOOD","5.17","6000","53500","59500","93","Mahesa Tarihoran S.Farm","L"
"2018","12","CAR","11.21","21600","0","21600","96","Bakda Gunawan","L"
"2018","12","SHOP","6.6","8000","33500","41500","104","Faizah Shania Usamah S.T.","P"
"2018","12","SHOP","12.5","17000","48000","65000","82","Latif Marbun","L"
"2018","12","SHOP","3.71","4000","64500","68500","77","Lukman Ganep Januar M.Ak","L"
"2018","12","SHOP","4.77","6000","78500","84500","77","Lukman Ganep Januar M.Ak","L"
"2018","12","FOOD","4.89","6000","25000","31000","85","Jarwadi Nababan","L"
"2018","12","SHOP","6.59","8000","97500","105500","103","Eka Tira Haryanti","P"
"2018","12","CAR","8.25","15600","0","15600","96","Bakda Gunawan","L"
"2018","12","SHOP","3.86","4000","44500","48500","84","Lukita Napitupulu","L"
"2018","12","FOOD","2.48","2000","67000","69000","106","Yunita Laras Pratiwi","P"
"2018","12","SHOP","4.33","5000","72000","77000","88","Jatmiko Waluyo S.Pd","L"
"2018","12","FOOD","11.26","15000","55500","70500","84","Lukita Napitupulu","L"
"2018","12","CAR","3.89","6000","0","6000","99","Joko Situmorang","L"
"2018","12","SHOP","5.29","6000","64000","70000","91","Margana Pratama","L"
"2018","12","SHOP","8.94","12000","92000","104000","87","Artanto Eman Wacana S.I.Kom","L"
"2018","12","FOOD","6.02","8000","78000","86000","83","Gaiman Hidayat S.Kom","L"
"2018","12","SHOP","8.35","11000","94000","105000","78","Maryadi Natsir","L"
"2018","12","FOOD","3.8","4000","64500","68500","90","Rusman Situmorang","L"
"2018","12","CAR","13.81","27600","0","27600","99","Joko Situmorang","L"
"2018","12","SHOP","7.2","9000","72000","81000","86","Daliono Firgantoro","L"
"2018","12","CAR","6.44","12000","0","12000","95","Cengkal Marpaung","L"
"2018","12","FOOD","5.91","7000","74500","81500","87","Artanto Eman Wacana S.I.Kom","L"
"2018","12","FOOD","7.24","9000","65000","74000","106","Yunita Laras Pratiwi","P"
"2018","12","SHOP","3.41","4000","46500","50500","83","Gaiman Hidayat S.Kom","L"
"2018","12","SHOP","9.61","13000","46000","59000","75","Atma Dasa Uwais","L"
"2018","12","SHOP","4.2","5000","58000","63000","104","Faizah Shania Usamah S.T.","P"
"2018","12","FOOD","7.62","10000","27000","37000","93","Mahesa Tarihoran S.Farm","L"
"2018","12","CAR","8.17","15600","0","15600","109","Maimunah Pudjiastuti","P"
"2018","12","SHOP","5.63","7000","54500","61500","87","Artanto Eman Wacana S.I.Kom","L"
"2018","12","BIKE","15.93","8000","0","8000","103","Eka Tira Haryanti","P"
"2018","12","CAR","8.73","16800","0","16800","97","Waluyo Setiawan","L"
"2018","12","SHOP","5.82","7000","43500","50500","89","Dirja Mansur","L"
"2018","12","CAR","13.83","27600","0","27600","97","Waluyo Setiawan","L"
"2018","12","SHOP","5.06","6000","50500","56500","78","Maryadi Natsir","L"
"2018","12","CAR","7.87","14400","0","14400","107","Gasti Nadia Pratiwi S.Gz","P"
"2018","12","SHOP","12.34","17000","36500","53500","85","Jarwadi Nababan","L"
"2018","12","BIKE","4.89","2000","0","2000","101","Kartika Winarsih S.Ked","P"
"2018","12","SHOP","5.44","7000","64000","71000","88","Jatmiko Waluyo S.Pd","L"
"2018","12","FOOD","7.26","9000","35500","44500","106","Yunita Laras Pratiwi","P"
"2018","12","CAR","9.2","18000","0","18000","98","Imam Abyasa Maheswara","L"
"2018","12","SHOP","3.93","4000","88500","92500","78","Maryadi Natsir","L"
"2018","12","SHOP","7.7","10000","94500","104500","81","Manah Sirait","L"
"2018","12","FOOD","5.13","6000","63500","69500","100","Halima Kani Purnawati","P"
"2018","12","FOOD","5.35","7000","98500","105500","75","Atma Dasa Uwais","L"
"2018","12","SHOP","3.57","4000","61000","65000","89","Dirja Mansur","L"
"2018","12","CAR","7.4","14400","0","14400","109","Maimunah Pudjiastuti","P"
"2018","12","SHOP","9.52","13000","43500","56500","88","Jatmiko Waluyo S.Pd","L"
"2018","12","SHOP","6.06","8000","88500","96500","78","Maryadi Natsir","L"
"2018","12","CAR","8.23","15600","0","15600","107","Gasti Nadia Pratiwi S.Gz","P"
"2018","12","FOOD","7.3","9000","82500","91500","84","Lukita Napitupulu","L"
"2018","12","CAR","12.76","25200","0","25200","109","Maimunah Pudjiastuti","P"
"2018","12","SHOP","9.76","13000","60000","73000","93","Mahesa Tarihoran S.Farm","L"
"2018","12","FOOD","8.83","12000","52000","64000","87","Artanto Eman Wacana S.I.Kom","L"
"2018","12","CAR","6.77","12000","0","12000","98","Imam Abyasa Maheswara","L"
"2018","12","SHOP","9.5","13000","77000","90000","88","Jatmiko Waluyo S.Pd","L"
"2018","12","CAR","5.32","9600","0","9600","108","Ana Maimunah Pertiwi S.H.","P"
"2018","12","CAR","4.12","7200","0","7200","95","Cengkal Marpaung","L"
"2018","12","SHOP","9.08","12000","38000","50000","106","Yunita Laras Pratiwi","P"
"2018","12","CAR","6.15","10800","0","10800","97","Waluyo Setiawan","L"
"2018","12","BIKE","7.41","3500","0","3500","81","Manah Sirait","L"
"2018","12","FOOD","8.18","11000","73500","84500","103","Eka Tira Haryanti","P"
"2018","12","CAR","4.5","7200","0","7200","108","Ana Maimunah Pertiwi S.H.","P"
"2018","12","FOOD","5.24","6000","51000","57000","75","Atma Dasa Uwais","L"
"2018","12","CAR","7.33","13200","0","13200","98","Imam Abyasa Maheswara","L"
"2018","12","SHOP","6.66","8000","76000","84000","104","Faizah Shania Usamah S.T.","P"
"2018","12","FOOD","4.12","5000","96000","101000","82","Latif Marbun","L"
"2018","12","SHOP","6.52","8000","34500","42500","77","Lukman Ganep Januar M.Ak","L"
"2018","12","FOOD","9.16","12000","51000","63000","84","Lukita Napitupulu","L"
"2018","12","SHOP","9.6","13000","62000","75000","88","Jatmiko Waluyo S.Pd","L"
"2018","12","FOOD","4.74","6000","83000","89000","103","Eka Tira Haryanti","P"
"2018","12","CAR","12.08","24000","0","24000","96","Bakda Gunawan","L"
"2018","12","CAR","8.29","15600","0","15600","99","Joko Situmorang","L"
"2018","12","CAR","7.8","14400","0","14400","108","Ana Maimunah Pertiwi S.H.","P"
"2018","12","FOOD","6.5","8000","96500","104500","88","Jatmiko Waluyo S.Pd","L"
"2018","12","BIKE","4.78","2000","0","2000","82","Latif Marbun","L"
"2018","12","FOOD","5.71","7000","85500","92500","77","Lukman Ganep Januar M.Ak","L"
"2018","12","CAR","4.9","8400","0","8400","97","Waluyo Setiawan","L"
"2018","12","SHOP","3.19","3000","51500","54500","93","Mahesa Tarihoran S.Farm","L"
"2018","12","FOOD","10.58","14000","93500","107500","85","Jarwadi Nababan","L"
"2018","12","SHOP","10.55","14000","71000","85000","83","Gaiman Hidayat S.Kom","L"
"2018","12","SHOP","3.58","4000","29000","33000","94","Harjo Karya Suwarno","L"
"2018","12","CAR","6.55","12000","0","12000","96","Bakda Gunawan","L"
"2018","12","SHOP","8.76","12000","42500","54500","102","Intan Nasyiah","P"
"2018","12","BIKE","15.16","8000","0","8000","93","Mahesa Tarihoran S.Farm","L"
"2018","12","CAR","5.67","9600","0","9600","107","Gasti Nadia Pratiwi S.Gz","P"
"2018","12","BIKE","2.78","1000","0","1000","94","Harjo Karya Suwarno","L"
"2018","12","FOOD","10.14","14000","62000","76000","84","Lukita Napitupulu","L"
"2018","12","CAR","9.13","18000","0","18000","97","Waluyo Setiawan","L"
"2018","12","SHOP","7.79","10000","87000","97000","84","Lukita Napitupulu","L"
"2018","12","CAR","8.73","16800","0","16800","109","Maimunah Pudjiastuti","P"
"2018","12","CAR","5.36","9600","0","9600","95","Cengkal Marpaung","L"
"2018","12","CAR","6.96","13200","0","13200","109","Maimunah Pudjiastuti","P"
"2018","12","SHOP","3.94","4000","48500","52500","100","Halima Kani Purnawati","P"
"2018","12","FOOD","6.69","9000","34500","43500","84","Lukita Napitupulu","L"
"2018","12","FOOD","9.43","13000","95500","108500","75","Atma Dasa Uwais","L"
"2018","12","SHOP","5.54","7000","68000","75000","103","Eka Tira Haryanti","P"
"2018","12","FOOD","7.39","10000","28500","38500","103","Eka Tira Haryanti","P"
"2018","12","FOOD","2.63","2000","64500","66500","93","Mahesa Tarihoran S.Farm","L"
"2018","12","SHOP","3.72","4000","31000","35000","91","Margana Pratama","L"
"2018","12","BIKE","3.52","1500","0","1500","106","Yunita Laras Pratiwi","P"
"2018","12","FOOD","9.04","12000","94500","106500","105","Restu Yuniar S.Pt","P"
"2018","12","SHOP","11.64","16000","33500","49500","85","Jarwadi Nababan","L"
"2018","12","SHOP","4.11","5000","86500","91500","78","Maryadi Natsir","L"
"2018","12","CAR","6.15","10800","0","10800","95","Cengkal Marpaung","L"
"2018","12","FOOD","2.85","3000","61000","64000","86","Daliono Firgantoro","L"
"2018","12","FOOD","9.41","13000","75000","88000","91","Margana Pratama","L"
"2018","12","SHOP","4.64","5000","86000","91000","105","Restu Yuniar S.Pt","P"
"2018","12","FOOD","8.38","11000","69000","80000","75","Atma Dasa Uwais","L"
"2018","12","SHOP","5.08","6000","47000","53000","80","Mursita Prasetya","L"
"2018","12","SHOP","4.17","5000","56000","61000","79","Jabal Prasetya S.Psi","L"
"2019","1","FOOD","755.97","1000","80500","81500","106","Yunita Laras Pratiwi","P"
"2018","12","CAR","4.38","7200","0","7200","107","Gasti Nadia Pratiwi S.Gz","P"
"2018","12","CAR","4.64","8400","0","8400","107","Gasti Nadia Pratiwi S.Gz","P"
"2018","12","FOOD","6.4","8000","52500","60500","77","Lukman Ganep Januar M.Ak","L"
"2018","12","FOOD","8.36","11000","60000","71000","90","Rusman Situmorang","L"
"2018","12","FOOD","10.68","15000","36000","51000","78","Maryadi Natsir","L"
"2018","12","CAR","4.82","8400","0","8400","107","Gasti Nadia Pratiwi S.Gz","P"
"2018","12","BIKE","8.13","4000","0","4000","90","Rusman Situmorang","L"
"2018","12","CAR","15.7","31200","0","31200","109","Maimunah Pudjiastuti","P"
"2018","12","BIKE","5.79","2500","0","2500","104","Faizah Shania Usamah S.T.","P"
"2018","12","CAR","5.47","9600","0","9600","99","Joko Situmorang","L"
"2018","12","BIKE","2.35","500","0","500","88","Jatmiko Waluyo S.Pd","L"
"2018","12","FOOD","7.29","9000","77500","86500","104","Faizah Shania Usamah S.T.","P"
"2018","12","CAR","8.78","16800","0","16800","95","Cengkal Marpaung","L"
"2018","12","SHOP","3.31","3000","61500","64500","105","Restu Yuniar S.Pt","P"
"2018","12","BIKE","3.84","1500","0","1500","105","Restu Yuniar S.Pt","P"
"2018","12","BIKE","5.72","2500","0","2500","83","Gaiman Hidayat S.Kom","L"
"2018","12","BIKE","6.49","3000","0","3000","88","Jatmiko Waluyo S.Pd","L"
"2018","12","SHOP","9.27","12000","96000","108000","93","Mahesa Tarihoran S.Farm","L"
"2018","12","CAR","10.65","20400","0","20400","98","Imam Abyasa Maheswara","L"
"2018","12","FOOD","5.08","6000","77500","83500","105","Restu Yuniar S.Pt","P"
"2018","12","CAR","8.03","15600","0","15600","108","Ana Maimunah Pertiwi S.H.","P"
"2018","12","BIKE","13.66","7000","0","7000","101","Kartika Winarsih S.Ked","P"
"2018","12","FOOD","5.87","7000","81000","88000","92","Danu Januar","L"
"2018","12","BIKE","5.62","2500","0","2500","82","Latif Marbun","L"
"2018","12","SHOP","9.98","13000","89500","102500","106","Yunita Laras Pratiwi","P"
"2018","12","CAR","6.96","13200","0","13200","96","Bakda Gunawan","L"
"2018","12","FOOD","762.13","1000","88000","89000","102","Intan Nasyiah","P"
"2018","12","FOOD","7.13","9000","29500","38500","94","Harjo Karya Suwarno","L"
"2018","12","CAR","7.04","13200","0","13200","109","Maimunah Pudjiastuti","P"
"2018","12","CAR","7.21","13200","0","13200","107","Gasti Nadia Pratiwi S.Gz","P"
"2018","12","CAR","2.68","3600","0","3600","109","Maimunah Pudjiastuti","P"
"2018","12","BIKE","8.58","4000","0","4000","78","Maryadi Natsir","L"
"2018","12","FOOD","7.31","9000","91000","100000","88","Jatmiko Waluyo S.Pd","L"
"2018","12","SHOP","7.04","9000","65000","74000","102","Intan Nasyiah","P"
"2018","12","BIKE","2.09","500","0","500","90","Rusman Situmorang","L"
"2018","12","BIKE","13.22","6500","0","6500","81","Manah Sirait","L"
"2018","12","BIKE","6.83","3000","0","3000","88","Jatmiko Waluyo S.Pd","L"
"2018","12","SHOP","10.03","14000","100000","114000","88","Jatmiko Waluyo S.Pd","L"
"2018","12","CAR","9.15","18000","0","18000","95","Cengkal Marpaung","L"
"2018","12","BIKE","9.87","5000","0","5000","105","Restu Yuniar S.Pt","P"
"2018","12","CAR","14.75","30000","0","30000","107","Gasti Nadia Pratiwi S.Gz","P"
"2018","12","CAR","6.65","12000","0","12000","108","Ana Maimunah Pertiwi S.H.","P"
"2018","12","SHOP","5.72","7000","50000","57000","94","Harjo Karya Suwarno","L"
"2018","12","BIKE","6.6","3000","0","3000","84","Lukita Napitupulu","L"
"2018","12","CAR","4.78","8400","0","8400","98","Imam Abyasa Maheswara","L"
"2018","12","BIKE","6.01","3000","0","3000","81","Manah Sirait","L"
"2018","12","CAR","6.12","10800","0","10800","98","Imam Abyasa Maheswara","L"
"2018","12","CAR","14.87","30000","0","30000","98","Imam Abyasa Maheswara","L"
"2018","12","BIKE","3.46","1500","0","1500","100","Halima Kani Purnawati","P"
"2018","12","SHOP","6.98","9000","41000","50000","83","Gaiman Hidayat S.Kom","L"
"2018","12","SHOP","11.34","16000","25500","41500","103","Eka Tira Haryanti","P"
"2018","12","FOOD","9.09","12000","46000","58000","85","Jarwadi Nababan","L"
"2018","12","BIKE","14.87","7500","0","7500","79","Jabal Prasetya S.Psi","L"
"2018","12","CAR","6.81","12000","0","12000","99","Joko Situmorang","L"
"2018","12","BIKE","9.43","4500","0","4500","77","Lukman Ganep Januar M.Ak","L"
"2018","12","BIKE","9.75","5000","0","5000","88","Jatmiko Waluyo S.Pd","L"
"2018","12","FOOD","7.56","10000","66500","76500","92","Danu Januar","L"
"2018","12","BIKE","5.1","2500","0","2500","104","Faizah Shania Usamah S.T.","P"
"2018","12","BIKE","7.18","3500","0","3500","88","Jatmiko Waluyo S.Pd","L"
"2018","12","BIKE","9.13","4500","0","4500","94","Harjo Karya Suwarno","L"
"2018","12","BIKE","6.87","3000","0","3000","81","Manah Sirait","L"
"2018","12","FOOD","8.63","11000","60000","71000","106","Yunita Laras Pratiwi","P"
"2018","12","CAR","13.74","27600","0","27600","108","Ana Maimunah Pertiwi S.H.","P"
"2018","12","BIKE","4.38","2000","0","2000","81","Manah Sirait","L"
"2018","12","FOOD","753.05","1000","44500","45500","86","Daliono Firgantoro","L"
"2018","12","FOOD","3.95","4000","64000","68000","92","Danu Januar","L"
"2018","12","BIKE","8.5","4000","0","4000","80","Mursita Prasetya","L"
"2018","12","FOOD","5.92","7000","31000","38000","86","Daliono Firgantoro","L"
"2018","12","FOOD","7.32","9000","40500","49500","103","Eka Tira Haryanti","P"
"2018","12","CAR","9.4","18000","0","18000","95","Cengkal Marpaung","L"
"2018","12","CAR","8.73","16800","0","16800","96","Bakda Gunawan","L"
"2018","12","SHOP","5.58","7000","37500","44500","86","Daliono Firgantoro","L"
"2018","12","BIKE","11.64","6000","0","6000","85","Jarwadi Nababan","L"
"2018","12","FOOD","5.35","7000","45500","52500","91","Margana Pratama","L"
"2018","12","BIKE","11.19","5500","0","5500","85","Jarwadi Nababan","L"
"2018","12","BIKE","6.55","3000","0","3000","88","Jatmiko Waluyo S.Pd","L"
"2018","12","CAR","5.38","9600","0","9600","97","Waluyo Setiawan","L"
"2018","12","CAR","12.12","24000","0","24000","97","Waluyo Setiawan","L"
"2018","12","BIKE","7.17","3500","0","3500","81","Manah Sirait","L"
"2018","12","FOOD","6.07","8000","81000","89000","78","Maryadi Natsir","L"
"2018","12","BIKE","5.54","2500","0","2500","103","Eka Tira Haryanti","P"
"2018","12","SHOP","3.02","3000","96500","99500","86","Daliono Firgantoro","L"
"2018","12","CAR","12.84","25200","0","25200","95","Cengkal Marpaung","L"
"2018","12","CAR","12.37","24000","0","24000","108","Ana Maimunah Pertiwi S.H.","P"
"2018","12","SHOP","3.58","4000","75500","79500","89","Dirja Mansur","L"
"2018","12","SHOP","6.89","9000","72000","81000","94","Harjo Karya Suwarno","L"
"2018","12","CAR","8.88","16800","0","16800","99","Joko Situmorang","L"
"2018","12","SHOP","5.59","7000","54000","61000","90","Rusman Situmorang","L"
"2018","12","BIKE","8.45","4000","0","4000","86","Daliono Firgantoro","L"
"2018","12","SHOP","2.95","3000","72000","75000","92","Danu Januar","L"
"2018","12","BIKE","7.75","3500","0","3500","83","Gaiman Hidayat S.Kom","L"
"2018","12","CAR","10.87","21600","0","21600","98","Imam Abyasa Maheswara","L"
"2018","12","BIKE","5.14","2500","0","2500","101","Kartika Winarsih S.Ked","P"
"2018","12","CAR","3.84","6000","0","6000","107","Gasti Nadia Pratiwi S.Gz","P"
"2018","12","CAR","6.69","12000","0","12000","108","Ana Maimunah Pertiwi S.H.","P"
"2018","12","BIKE","9.96","5000","0","5000","94","Harjo Karya Suwarno","L"
"2018","12","FOOD","7.12","9000","55000","64000","94","Harjo Karya Suwarno","L"
"2018","12","CAR","5.82","10800","0","10800","98","Imam Abyasa Maheswara","L"
"2018","12","BIKE","8.62","4000","0","4000","85","Jarwadi Nababan","L"
"2018","12","BIKE","4.71","2000","0","2000","75","Atma Dasa Uwais","L"
"2018","11","FOOD","4.85","6000","73000","79000","105","Restu Yuniar S.Pt","P"
"2018","11","FOOD","5.12","6000","89000","95000","92","Danu Januar","L"
"2018","11","BIKE","11.59","6000","0","6000","75","Atma Dasa Uwais","L"
"2018","11","SHOP","5.32","6000","56500","62500","102","Intan Nasyiah","P"
"2018","11","FOOD","5.62","7000","59000","66000","77","Lukman Ganep Januar M.Ak","L"
"2018","11","BIKE","3.24","1000","0","1000","88","Jatmiko Waluyo S.Pd","L"
"2018","11","BIKE","8.43","4000","0","4000","104","Faizah Shania Usamah S.T.","P"
"2018","11","BIKE","8.13","4000","0","4000","103","Eka Tira Haryanti","P"
"2018","11","FOOD","4.81","6000","94500","100500","82","Latif Marbun","L"
"2018","11","BIKE","8.51","4000","0","4000","81","Manah Sirait","L"
"2018","11","SHOP","7.39","10000","37000","47000","89","Dirja Mansur","L"
"2018","11","BIKE","6.1","3000","0","3000","104","Faizah Shania Usamah S.T.","P"
"2018","11","SHOP","6.72","9000","77000","86000","93","Mahesa Tarihoran S.Farm","L"
"2018","11","BIKE","8.19","4000","0","4000","88","Jatmiko Waluyo S.Pd","L"
"2018","11","BIKE","6.93","3500","0","3500","82","Latif Marbun","L"
"2018","11","BIKE","5.22","2500","0","2500","91","Margana Pratama","L"
"2018","11","CAR","6.21","10800","0","10800","109","Maimunah Pudjiastuti","P"
"2018","11","BIKE","11.68","6000","0","6000","89","Dirja Mansur","L"
"2018","11","BIKE","5.73","2500","0","2500","92","Danu Januar","L"
"2018","11","CAR","11.2","21600","0","21600","109","Maimunah Pudjiastuti","P"
"2018","11","BIKE","8.94","4500","0","4500","106","Yunita Laras Pratiwi","P"
"2018","11","CAR","8.26","15600","0","15600","98","Imam Abyasa Maheswara","L"
"2018","11","CAR","7.69","14400","0","14400","99","Joko Situmorang","L"
"2018","11","BIKE","5.69","2500","0","2500","76","Paiman Wacana S.Kom","L"
"2018","11","BIKE","10.05","5000","0","5000","94","Harjo Karya Suwarno","L"
"2018","11","SHOP","3.15","3000","95500","98500","85","Jarwadi Nababan","L"
"2018","11","CAR","10.19","20400","0","20400","96","Bakda Gunawan","L"
"2018","11","CAR","10.71","20400","0","20400","96","Bakda Gunawan","L"
"2018","11","SHOP","7.67","10000","42500","52500","102","Intan Nasyiah","P"
"2018","11","BIKE","9.76","5000","0","5000","82","Latif Marbun","L"
"2018","11","FOOD","5.45","7000","64500","71500","101","Kartika Winarsih S.Ked","P"
"2018","11","BIKE","13.42","7000","0","7000","77","Lukman Ganep Januar M.Ak","L"
"2018","11","BIKE","2.98","1000","0","1000","106","Yunita Laras Pratiwi","P"
"2018","11","CAR","4.04","6000","0","6000","107","Gasti Nadia Pratiwi S.Gz","P"
"2018","11","FOOD","6.03","8000","59500","67500","87","Artanto Eman Wacana S.I.Kom","L"
"2018","11","BIKE","10.25","5000","0","5000","106","Yunita Laras Pratiwi","P"
"2018","11","FOOD","13.46","19000","85500","104500","81","Manah Sirait","L"
"2018","11","BIKE","5.93","2500","0","2500","79","Jabal Prasetya S.Psi","L"
"2018","11","CAR","6.51","12000","0","12000","97","Waluyo Setiawan","L"
"2018","11","BIKE","9.01","4500","0","4500","83","Gaiman Hidayat S.Kom","L"
"2018","11","BIKE","5.34","2500","0","2500","92","Danu Januar","L"
"2018","11","CAR","8.32","15600","0","15600","107","Gasti Nadia Pratiwi S.Gz","P"
"2018","11","BIKE","14.6","7500","0","7500","105","Restu Yuniar S.Pt","P"
"2018","11","FOOD","7.23","9000","28500","37500","80","Mursita Prasetya","L"
"2018","11","BIKE","5.13","2500","0","2500","77","Lukman Ganep Januar M.Ak","L"
"2018","11","BIKE","4.61","2000","0","2000","78","Maryadi Natsir","L"
"2018","11","BIKE","6.21","3000","0","3000","91","Margana Pratama","L"
"2018","11","FOOD","6.12","8000","72500","80500","77","Lukman Ganep Januar M.Ak","L"
"2018","11","CAR","8.07","15600","0","15600","96","Bakda Gunawan","L"
"2018","11","CAR","9.02","16800","0","16800","97","Waluyo Setiawan","L"
"2018","11","SHOP","6.29","8000","59500","67500","91","Margana Pratama","L"
"2018","11","BIKE","13.09","6500","0","6500","81","Manah Sirait","L"
"2018","11","FOOD","5.6","7000","42500","49500","100","Halima Kani Purnawati","P"
"2018","11","BIKE","10.67","5500","0","5500","80","Mursita Prasetya","L"
"2018","11","FOOD","3.62","4000","90000","94000","90","Rusman Situmorang","L"
"2018","11","FOOD","6.31","8000","78500","86500","103","Eka Tira Haryanti","P"
"2018","11","BIKE","10.21","5000","0","5000","106","Yunita Laras Pratiwi","P"
"2018","11","FOOD","5.03","6000","31500","37500","81","Manah Sirait","L"
"2018","11","CAR","3.67","6000","0","6000","99","Joko Situmorang","L"
"2018","11","FOOD","3.69","4000","60500","64500","93","Mahesa Tarihoran S.Farm","L"
"2018","11","SHOP","5.6","7000","42500","49500","82","Latif Marbun","L"
"2018","11","SHOP","3.37","4000","27000","31000","94","Harjo Karya Suwarno","L"
"2018","11","BIKE","9.61","4500","0","4500","76","Paiman Wacana S.Kom","L"
"2018","11","CAR","7.73","14400","0","14400","96","Bakda Gunawan","L"
"2018","11","FOOD","10.24","14000","39000","53000","79","Jabal Prasetya S.Psi","L"
"2018","11","BIKE","6.21","3000","0","3000","89","Dirja Mansur","L"
"2018","11","BIKE","9.28","4500","0","4500","75","Atma Dasa Uwais","L"
"2018","11","CAR","3.09","4800","0","4800","107","Gasti Nadia Pratiwi S.Gz","P"
"2018","11","CAR","13.89","27600","0","27600","98","Imam Abyasa Maheswara","L"
"2018","11","BIKE","3.33","1500","0","1500","89","Dirja Mansur","L"
"2018","11","BIKE","6.32","3000","0","3000","78","Maryadi Natsir","L"
"2018","11","FOOD","8.98","12000","71000","83000","78","Maryadi Natsir","L"
"2018","11","FOOD","6.94","9000","57500","66500","82","Latif Marbun","L"
"2018","11","FOOD","6.21","8000","99500","107500","105","Restu Yuniar S.Pt","P"
"2018","11","BIKE","12.25","6000","0","6000","88","Jatmiko Waluyo S.Pd","L"
"2018","11","FOOD","6.53","8000","68000","76000","85","Jarwadi Nababan","L"
"2018","11","SHOP","8.7","12000","56500","68500","82","Latif Marbun","L"
"2018","11","BIKE","8.88","4500","0","4500","90","Rusman Situmorang","L"
"2018","11","BIKE","10.9","5500","0","5500","79","Jabal Prasetya S.Psi","L"
"2018","11","FOOD","10.47","14000","38500","52500","103","Eka Tira Haryanti","P"
"2018","11","BIKE","6.55","3000","0","3000","88","Jatmiko Waluyo S.Pd","L"
"2018","11","BIKE","10.15","5000","0","5000","100","Halima Kani Purnawati","P"
"2018","11","BIKE","5.66","2500","0","2500","103","Eka Tira Haryanti","P"
"2018","11","BIKE","7.94","4000","0","4000","103","Eka Tira Haryanti","P"
"2018","11","BIKE","10.35","5000","0","5000","102","Intan Nasyiah","P"
"2018","11","BIKE","10.96","5500","0","5500","83","Gaiman Hidayat S.Kom","L"
"2018","11","BIKE","6.27","3000","0","3000","92","Danu Januar","L"
"2018","11","SHOP","5.95","7000","89000","96000","82","Latif Marbun","L"
"2018","11","BIKE","14.35","7500","0","7500","82","Latif Marbun","L"
"2018","11","BIKE","9.78","5000","0","5000","104","Faizah Shania Usamah S.T.","P"
"2018","11","CAR","6.45","12000","0","12000","95","Cengkal Marpaung","L"
"2018","11","BIKE","3.51","1500","0","1500","101","Kartika Winarsih S.Ked","P"
"2018","11","SHOP","3.61","4000","46500","50500","83","Gaiman Hidayat S.Kom","L"
"2018","11","BIKE","7.43","3500","0","3500","87","Artanto Eman Wacana S.I.Kom","L"
"2018","11","BIKE","8.28","4000","0","4000","100","Halima Kani Purnawati","P"
"2018","11","BIKE","8.53","4000","0","4000","81","Manah Sirait","L"
"2018","11","BIKE","2.33","500","0","500","88","Jatmiko Waluyo S.Pd","L"
"2018","11","FOOD","3.37","4000","33500","37500","81","Manah Sirait","L"
"2018","11","SHOP","5.51","7000","40500","47500","94","Harjo Karya Suwarno","L"
"2018","11","BIKE","3.18","1000","0","1000","90","Rusman Situmorang","L"
"2018","11","BIKE","12","6000","0","6000","104","Faizah Shania Usamah S.T.","P"
"2018","11","FOOD","3.87","4000","59500","63500","89","Dirja Mansur","L"
"2018","11","BIKE","4.79","2000","0","2000","78","Maryadi Natsir","L"
"2018","11","CAR","11.56","22800","0","22800","96","Bakda Gunawan","L"
"2018","11","BIKE","12.49","6500","0","6500","104","Faizah Shania Usamah S.T.","P"
"2018","11","CAR","8.39","15600","0","15600","107","Gasti Nadia Pratiwi S.Gz","P"
"2018","11","BIKE","6.03","3000","0","3000","79","Jabal Prasetya S.Psi","L"
"2018","11","SHOP","9.68","13000","98500","111500","87","Artanto Eman Wacana S.I.Kom","L"
"2018","11","SHOP","8.49","11000","58000","69000","82","Latif Marbun","L"
"2018","11","BIKE","14.07","7000","0","7000","89","Dirja Mansur","L"
"2018","11","SHOP","10.09","14000","76500","90500","82","Latif Marbun","L"
"2018","11","FOOD","7.38","10000","70500","80500","100","Halima Kani Purnawati","P"
"2018","11","CAR","15.46","31200","0","31200","97","Waluyo Setiawan","L"
"2018","11","CAR","10.88","21600","0","21600","98","Imam Abyasa Maheswara","L"
"2018","11","CAR","2.74","3600","0","3600","107","Gasti Nadia Pratiwi S.Gz","P"
"2018","11","BIKE","6.67","3000","0","3000","75","Atma Dasa Uwais","L"
"2018","11","SHOP","7.9","10000","52500","62500","105","Restu Yuniar S.Pt","P"
"2018","11","FOOD","5.09","6000","53000","59000","102","Intan Nasyiah","P"
"2018","11","CAR","10.67","20400","0","20400","98","Imam Abyasa Maheswara","L"
"2018","11","FOOD","7.19","9000","96000","105000","81","Manah Sirait","L"
"2018","11","BIKE","8.84","4500","0","4500","104","Faizah Shania Usamah S.T.","P"
"2018","11","BIKE","6.39","3000","0","3000","93","Mahesa Tarihoran S.Farm","L"
"2018","11","FOOD","10.07","14000","78000","92000","94","Harjo Karya Suwarno","L"
"2018","11","SHOP","5.63","7000","65000","72000","82","Latif Marbun","L"
"2018","11","BIKE","10.01","5000","0","5000","94","Harjo Karya Suwarno","L"
"2018","11","BIKE","7.61","3500","0","3500","91","Margana Pratama","L"
"2018","11","BIKE","6.38","3000","0","3000","94","Harjo Karya Suwarno","L"
"2018","11","BIKE","14.26","7500","0","7500","94","Harjo Karya Suwarno","L"
"2018","11","BIKE","7.3","3500","0","3500","106","Yunita Laras Pratiwi","P"
"2018","10","SHOP","4.44","5000","81500","86500","91","Margana Pratama","L"
"2018","10","BIKE","4.34","2000","0","2000","83","Gaiman Hidayat S.Kom","L"
"2018","10","FOOD","7.84","10000","76500","86500","79","Jabal Prasetya S.Psi","L"
"2018","10","FOOD","4.73","6000","38500","44500","84","Lukita Napitupulu","L"
"2018","10","BIKE","5.37","2500","0","2500","94","Harjo Karya Suwarno","L"
"2018","10","SHOP","9.65","13000","35000","48000","88","Jatmiko Waluyo S.Pd","L"
"2018","10","FOOD","3.84","4000","58000","62000","75","Atma Dasa Uwais","L"
"2018","10","FOOD","6.83","9000","62000","71000","87","Artanto Eman Wacana S.I.Kom","L"
"2018","10","CAR","5.77","10800","0","10800","97","Waluyo Setiawan","L"
"2018","10","BIKE","7.75","3500","0","3500","80","Mursita Prasetya","L"
"2018","10","FOOD","8.91","12000","55000","67000","85","Jarwadi Nababan","L"
"2018","10","FOOD","6.67","9000","40000","49000","75","Atma Dasa Uwais","L"
"2018","10","BIKE","6.92","3500","0","3500","90","Rusman Situmorang","L"
"2018","10","CAR","4.4","7200","0","7200","95","Cengkal Marpaung","L"
"2018","10","FOOD","5.7","7000","74000","81000","86","Daliono Firgantoro","L"
"2018","10","SHOP","6.01","8000","64000","72000","87","Artanto Eman Wacana S.I.Kom","L"
"2018","10","BIKE","12.94","6500","0","6500","100","Halima Kani Purnawati","P"
"2018","10","CAR","7.51","14400","0","14400","99","Joko Situmorang","L"
"2018","10","FOOD","6.06","8000","77500","85500","78","Maryadi Natsir","L"
"2018","10","BIKE","5.88","2500","0","2500","85","Jarwadi Nababan","L"
"2018","10","FOOD","6.34","8000","59500","67500","88","Jatmiko Waluyo S.Pd","L"
"2018","10","FOOD","5.77","7000","60000","67000","103","Eka Tira Haryanti","P"
"2018","10","FOOD","2.98","3000","58000","61000","75","Atma Dasa Uwais","L"
"2018","10","FOOD","6.8","9000","88500","97500","91","Margana Pratama","L"
"2018","10","FOOD","4.37","5000","67000","72000","101","Kartika Winarsih S.Ked","P"
"2018","10","BIKE","10.5","5000","0","5000","78","Maryadi Natsir","L"
"2018","10","CAR","4.05","6000","0","6000","96","Bakda Gunawan","L"
"2018","10","FOOD","5.68","7000","43500","50500","90","Rusman Situmorang","L"
"2018","10","BIKE","14.22","7500","0","7500","90","Rusman Situmorang","L"
"2018","10","BIKE","9.83","5000","0","5000","100","Halima Kani Purnawati","P"
"2018","10","BIKE","7.74","3500","0","3500","76","Paiman Wacana S.Kom","L"
"2018","10","FOOD","4.8","6000","71500","77500","103","Eka Tira Haryanti","P"
"2018","10","BIKE","10.34","5000","0","5000","106","Yunita Laras Pratiwi","P"
"2018","10","FOOD","4.39","5000","72500","77500","76","Paiman Wacana S.Kom","L"
"2018","10","FOOD","5.49","7000","49500","56500","92","Danu Januar","L"
"2018","10","BIKE","4.91","2000","0","2000","76","Paiman Wacana S.Kom","L"
"2018","10","SHOP","4.05","5000","85500","90500","103","Eka Tira Haryanti","P"
"2018","10","BIKE","12.33","6000","0","6000","105","Restu Yuniar S.Pt","P"
"2018","10","BIKE","7.34","3500","0","3500","100","Halima Kani Purnawati","P"
"2018","10","CAR","8.74","16800","0","16800","96","Bakda Gunawan","L"
"2018","10","CAR","4.77","8400","0","8400","96","Bakda Gunawan","L"
"2018","10","FOOD","5.71","7000","71500","78500","83","Gaiman Hidayat S.Kom","L"
"2018","10","SHOP","9.27","12000","82500","94500","81","Manah Sirait","L"
"2018","10","BIKE","6.27","3000","0","3000","103","Eka Tira Haryanti","P"
"2018","10","BIKE","12.88","6500","0","6500","87","Artanto Eman Wacana S.I.Kom","L"
"2018","10","BIKE","3.26","1000","0","1000","101","Kartika Winarsih S.Ked","P"
"2018","10","BIKE","12.28","6000","0","6000","106","Yunita Laras Pratiwi","P"
"2018","10","CAR","7.99","15600","0","15600","96","Bakda Gunawan","L"
"2018","10","FOOD","5.2","6000","56000","62000","78","Maryadi Natsir","L"
"2018","10","CAR","5.3","9600","0","9600","96","Bakda Gunawan","L"
"2018","10","FOOD","5.62","7000","68000","75000","90","Rusman Situmorang","L"
"2018","10","BIKE","8.37","4000","0","4000","91","Margana Pratama","L"
"2018","10","BIKE","13.07","6500","0","6500","77","Lukman Ganep Januar M.Ak","L"
"2018","10","CAR","5.81","10800","0","10800","95","Cengkal Marpaung","L"
"2018","10","FOOD","4.33","5000","75000","80000","94","Harjo Karya Suwarno","L"
"2018","10","FOOD","5.73","7000","51000","58000","79","Jabal Prasetya S.Psi","L"
"2018","10","BIKE","8.59","4000","0","4000","88","Jatmiko Waluyo S.Pd","L"
"2018","10","CAR","5.28","9600","0","9600","97","Waluyo Setiawan","L"
"2018","10","FOOD","5.2","6000","93000","99000","90","Rusman Situmorang","L"
"2018","10","BIKE","13.93","7000","0","7000","90","Rusman Situmorang","L"
"2018","10","BIKE","3.66","1500","0","1500","106","Yunita Laras Pratiwi","P"
"2018","10","SHOP","7.27","9000","73500","82500","87","Artanto Eman Wacana S.I.Kom","L"
"2018","10","BIKE","4.78","2000","0","2000","82","Latif Marbun","L"
"2018","10","BIKE","3.71","1500","0","1500","88","Jatmiko Waluyo S.Pd","L"
"2018","10","BIKE","7.33","3500","0","3500","83","Gaiman Hidayat S.Kom","L"
"2018","10","BIKE","7.48","3500","0","3500","87","Artanto Eman Wacana S.I.Kom","L"
"2018","10","BIKE","4.31","2000","0","2000","91","Margana Pratama","L"
"2018","10","BIKE","8.95","4500","0","4500","90","Rusman Situmorang","L"
"2018","11","FOOD","762.04","1000","76000","77000","77","Lukman Ganep Januar M.Ak","L"
"2018","10","FOOD","5.93","7000","62500","69500","103","Eka Tira Haryanti","P"
"2018","10","CAR","4.07","7200","0","7200","98","Imam Abyasa Maheswara","L"
"2018","10","SHOP","6.39","8000","52500","60500","87","Artanto Eman Wacana S.I.Kom","L"
"2018","10","BIKE","7.16","3500","0","3500","92","Danu Januar","L"
"2018","10","BIKE","10.91","5500","0","5500","106","Yunita Laras Pratiwi","P"
"2018","10","BIKE","9.03","4500","0","4500","77","Lukman Ganep Januar M.Ak","L"
"2018","10","BIKE","6.53","3000","0","3000","88","Jatmiko Waluyo S.Pd","L"
"2018","10","BIKE","12.06","6000","0","6000","102","Intan Nasyiah","P"
"2018","10","BIKE","7.38","3500","0","3500","87","Artanto Eman Wacana S.I.Kom","L"
"2018","10","BIKE","14.02","7000","0","7000","78","Maryadi Natsir","L"
"2018","10","BIKE","15.22","8000","0","8000","103","Eka Tira Haryanti","P"
"2018","10","FOOD","4.92","6000","31500","37500","77","Lukman Ganep Januar M.Ak","L"
"2018","10","BIKE","12.62","6500","0","6500","76","Paiman Wacana S.Kom","L"
"2018","10","BIKE","11.28","5500","0","5500","94","Harjo Karya Suwarno","L"
"2018","10","SHOP","4.71","6000","78500","84500","79","Jabal Prasetya S.Psi","L"
"2018","10","BIKE","3.28","1500","0","1500","77","Lukman Ganep Januar M.Ak","L"
"2018","10","CAR","6.24","10800","0","10800","95","Cengkal Marpaung","L"
"2018","10","BIKE","5.14","2500","0","2500","105","Restu Yuniar S.Pt","P"
"2018","10","BIKE","3.08","1000","0","1000","82","Latif Marbun","L"
"2018","10","BIKE","7.76","3500","0","3500","91","Margana Pratama","L"
"2018","10","FOOD","5.18","6000","98000","104000","89","Dirja Mansur","L"
"2018","10","CAR","6.42","12000","0","12000","95","Cengkal Marpaung","L"
"2018","10","FOOD","6.17","8000","66000","74000","100","Halima Kani Purnawati","P"
"2018","10","BIKE","9.11","4500","0","4500","86","Daliono Firgantoro","L"
"2018","10","BIKE","8.14","4000","0","4000","77","Lukman Ganep Januar M.Ak","L"
"2018","10","FOOD","4.8","6000","54500","60500","85","Jarwadi Nababan","L"
"2018","10","BIKE","10.32","5000","0","5000","91","Margana Pratama","L"
"2018","10","SHOP","9.5","13000","44000","57000","93","Mahesa Tarihoran S.Farm","L"
"2018","10","BIKE","9.19","4500","0","4500","106","Yunita Laras Pratiwi","P"
"2018","10","CAR","3.16","4800","0","4800","97","Waluyo Setiawan","L"
"2018","10","FOOD","10.81","15000","72000","87000","87","Artanto Eman Wacana S.I.Kom","L"
"2018","10","FOOD","5.25","6000","31500","37500","76","Paiman Wacana S.Kom","L"
"2018","10","CAR","6.3","12000","0","12000","109","Maimunah Pudjiastuti","P"
"2018","10","SHOP","3.68","4000","60500","64500","105","Restu Yuniar S.Pt","P"
"2018","10","SHOP","6.12","8000","39500","47500","91","Margana Pratama","L"
"2018","10","BIKE","9.11","4500","0","4500","76","Paiman Wacana S.Kom","L"
"2018","10","CAR","5.7","9600","0","9600","99","Joko Situmorang","L"
"2018","10","FOOD","7.22","9000","37000","46000","84","Lukita Napitupulu","L"
"2018","10","BIKE","4.63","2000","0","2000","101","Kartika Winarsih S.Ked","P"
"2018","10","FOOD","7.66","10000","48000","58000","76","Paiman Wacana S.Kom","L"
"2018","10","BIKE","8.2","4000","0","4000","88","Jatmiko Waluyo S.Pd","L"
"2018","10","BIKE","8.39","4000","0","4000","88","Jatmiko Waluyo S.Pd","L"
"2018","10","BIKE","9.28","4500","0","4500","105","Restu Yuniar S.Pt","P"
"2018","10","CAR","6.22","10800","0","10800","108","Ana Maimunah Pertiwi S.H.","P"
"2018","10","BIKE","11.92","6000","0","6000","85","Jarwadi Nababan","L"
"2018","10","SHOP","5.57","7000","82000","89000","84","Lukita Napitupulu","L"
"2018","10","BIKE","6.09","3000","0","3000","105","Restu Yuniar S.Pt","P"
"2018","10","BIKE","3.87","1500","0","1500","92","Danu Januar","L"
"2018","10","FOOD","5.86","7000","87500","94500","94","Harjo Karya Suwarno","L"
"2018","10","SHOP","6.29","8000","54000","62000","100","Halima Kani Purnawati","P"
"2018","10","FOOD","9.58","13000","76000","89000","91","Margana Pratama","L"
"2018","10","BIKE","3.47","1500","0","1500","75","Atma Dasa Uwais","L"
"2018","10","SHOP","7.56","10000","77500","87500","91","Margana Pratama","L"
"2018","10","FOOD","8.22","11000","51500","62500","79","Jabal Prasetya S.Psi","L"
"2018","10","BIKE","8.07","4000","0","4000","82","Latif Marbun","L"
"2018","10","CAR","9.78","19200","0","19200","99","Joko Situmorang","L"
"2018","10","CAR","6.83","12000","0","12000","95","Cengkal Marpaung","L"
"2018","10","BIKE","7.95","4000","0","4000","87","Artanto Eman Wacana S.I.Kom","L"
"2018","10","BIKE","10.38","5000","0","5000","84","Lukita Napitupulu","L"
"2018","10","BIKE","6.86","3000","0","3000","106","Yunita Laras Pratiwi","P"
"2018","10","FOOD","9.07","12000","40500","52500","101","Kartika Winarsih S.Ked","P"
"2018","10","FOOD","2.68","3000","67000","70000","88","Jatmiko Waluyo S.Pd","L"
"2018","10","SHOP","5.1","6000","42500","48500","94","Harjo Karya Suwarno","L"
"2018","10","SHOP","5.17","6000","81500","87500","83","Gaiman Hidayat S.Kom","L"
"2018","10","CAR","8.06","15600","0","15600","97","Waluyo Setiawan","L"
"2018","10","CAR","4.44","7200","0","7200","95","Cengkal Marpaung","L"
"2018","10","FOOD","4.3","5000","48000","53000","79","Jabal Prasetya S.Psi","L"
"2018","10","BIKE","10.29","5000","0","5000","104","Faizah Shania Usamah S.T.","P"
"2018","10","SHOP","6.41","8000","45000","53000","90","Rusman Situmorang","L"
"2018","10","CAR","10.21","20400","0","20400","109","Maimunah Pudjiastuti","P"
"2018","10","FOOD","4.57","5000","63500","68500","88","Jatmiko Waluyo S.Pd","L"
"2018","10","CAR","9.63","19200","0","19200","96","Bakda Gunawan","L"
"2018","10","FOOD","9.28","12000","51000","63000","102","Intan Nasyiah","P"
"2018","10","CAR","10.63","20400","0","20400","98","Imam Abyasa Maheswara","L"
"2018","10","BIKE","6.1","3000","0","3000","105","Restu Yuniar S.Pt","P"
"2018","9","BIKE","8.21","4000","0","4000","86","Daliono Firgantoro","L"
"2018","9","FOOD","5.66","7000","79500","86500","82","Latif Marbun","L"
"2018","9","BIKE","7.75","3500","0","3500","81","Manah Sirait","L"
"2018","9","BIKE","10.6","5500","0","5500","94","Harjo Karya Suwarno","L"
"2018","9","BIKE","3.31","1500","0","1500","94","Harjo Karya Suwarno","L"
"2018","9","BIKE","6.78","3000","0","3000","88","Jatmiko Waluyo S.Pd","L"
"2018","9","BIKE","9.51","4500","0","4500","82","Latif Marbun","L"
"2018","9","CAR","4.85","8400","0","8400","99","Joko Situmorang","L"
"2018","9","SHOP","5.69","7000","41000","48000","104","Faizah Shania Usamah S.T.","P"
"2018","9","CAR","10.49","20400","0","20400","96","Bakda Gunawan","L"
"2018","9","FOOD","3.73","4000","61500","65500","106","Yunita Laras Pratiwi","P"
"2018","9","FOOD","8.97","12000","43000","55000","100","Halima Kani Purnawati","P"
"2018","9","CAR","3.1","4800","0","4800","97","Waluyo Setiawan","L"
"2018","9","CAR","11.36","22800","0","22800","95","Cengkal Marpaung","L"
"2018","9","CAR","6.75","12000","0","12000","97","Waluyo Setiawan","L"
"2018","9","FOOD","8.97","12000","28000","40000","91","Margana Pratama","L"
"2018","9","BIKE","5.05","2000","0","2000","102","Intan Nasyiah","P"
"2018","9","FOOD","7.91","10000","53000","63000","100","Halima Kani Purnawati","P"
"2018","9","FOOD","4.8","6000","95000","101000","78","Maryadi Natsir","L"
"2018","9","FOOD","4.96","6000","68500","74500","84","Lukita Napitupulu","L"
"2018","9","BIKE","12.07","6000","0","6000","105","Restu Yuniar S.Pt","P"
"2018","9","SHOP","4.1","5000","86500","91500","85","Jarwadi Nababan","L"
"2018","9","FOOD","9.43","13000","99500","112500","94","Harjo Karya Suwarno","L"
"2018","9","BIKE","6.82","3000","0","3000","93","Mahesa Tarihoran S.Farm","L"
"2018","9","FOOD","3.61","4000","66500","70500","77","Lukman Ganep Januar M.Ak","L"
"2018","9","SHOP","10.3","14000","33500","47500","100","Halima Kani Purnawati","P"
"2018","9","BIKE","12.92","6500","0","6500","90","Rusman Situmorang","L"
"2018","9","SHOP","8.38","11000","89500","100500","79","Jabal Prasetya S.Psi","L"
"2018","9","FOOD","4.96","6000","78000","84000","105","Restu Yuniar S.Pt","P"
"2018","9","SHOP","4.72","6000","29000","35000","85","Jarwadi Nababan","L"
"2018","9","BIKE","8.44","4000","0","4000","85","Jarwadi Nababan","L"
"2018","9","FOOD","10.67","15000","30000","45000","82","Latif Marbun","L"
"2018","9","BIKE","2.97","1000","0","1000","87","Artanto Eman Wacana S.I.Kom","L"
"2018","9","BIKE","11.18","5500","0","5500","81","Manah Sirait","L"
"2018","9","FOOD","6.5","8000","79000","87000","100","Halima Kani Purnawati","P"
"2018","9","FOOD","6.89","9000","51500","60500","87","Artanto Eman Wacana S.I.Kom","L"
"2018","9","BIKE","10.27","5000","0","5000","79","Jabal Prasetya S.Psi","L"
"2018","9","BIKE","11.34","5500","0","5500","105","Restu Yuniar S.Pt","P"
"2018","9","BIKE","4.89","2000","0","2000","85","Jarwadi Nababan","L"
"2018","9","BIKE","12.36","6000","0","6000","105","Restu Yuniar S.Pt","P"
"2018","9","BIKE","6.5","3000","0","3000","102","Intan Nasyiah","P"
"2018","9","BIKE","2.2","500","0","500","87","Artanto Eman Wacana S.I.Kom","L"
"2018","9","FOOD","5.32","6000","51500","57500","77","Lukman Ganep Januar M.Ak","L"
"2018","9","FOOD","9.89","13000","83000","96000","83","Gaiman Hidayat S.Kom","L"
"2018","9","CAR","13.89","27600","0","27600","95","Cengkal Marpaung","L"
"2018","9","FOOD","7.19","9000","44500","53500","104","Faizah Shania Usamah S.T.","P"
"2018","9","CAR","14.51","28800","0","28800","95","Cengkal Marpaung","L"
"2018","9","SHOP","3.56","4000","89000","93000","101","Kartika Winarsih S.Ked","P"
"2018","9","FOOD","3.95","4000","84500","88500","80","Mursita Prasetya","L"
"2018","9","FOOD","5.48","7000","37000","44000","90","Rusman Situmorang","L"
"2018","9","FOOD","5.98","7000","52500","59500","102","Intan Nasyiah","P"
"2018","9","CAR","6.07","10800","0","10800","95","Cengkal Marpaung","L"
"2018","9","SHOP","9.51","13000","54000","67000","81","Manah Sirait","L"
"2018","9","FOOD","4.99","6000","48500","54500","91","Margana Pratama","L"
"2018","9","BIKE","3.1","1000","0","1000","76","Paiman Wacana S.Kom","L"
"2018","9","BIKE","6.52","3000","0","3000","91","Margana Pratama","L"
"2018","9","CAR","7.8","14400","0","14400","98","Imam Abyasa Maheswara","L"
"2018","9","BIKE","4.55","2000","0","2000","90","Rusman Situmorang","L"
"2018","9","SHOP","6.64","8000","60000","68000","77","Lukman Ganep Januar M.Ak","L"
"2018","9","BIKE","5.92","2500","0","2500","94","Harjo Karya Suwarno","L"
"2018","9","FOOD","5.58","7000","59000","66000","106","Yunita Laras Pratiwi","P"
"2018","9","FOOD","5.9","7000","68500","75500","88","Jatmiko Waluyo S.Pd","L"
"2018","9","FOOD","5.91","7000","81500","88500","79","Jabal Prasetya S.Psi","L"
"2018","9","BIKE","2.65","1000","0","1000","101","Kartika Winarsih S.Ked","P"
"2018","9","BIKE","5.94","2500","0","2500","91","Margana Pratama","L"
"2018","9","BIKE","9.47","4500","0","4500","102","Intan Nasyiah","P"
"2018","9","BIKE","3.74","1500","0","1500","103","Eka Tira Haryanti","P"
"2018","9","FOOD","4.76","6000","96000","102000","82","Latif Marbun","L"
"2018","9","BIKE","8.47","4000","0","4000","93","Mahesa Tarihoran S.Farm","L"
"2018","9","FOOD","8.19","11000","49000","60000","103","Eka Tira Haryanti","P"
"2018","9","BIKE","11.64","6000","0","6000","86","Daliono Firgantoro","L"
"2018","9","FOOD","5.42","7000","74000","81000","101","Kartika Winarsih S.Ked","P"
"2018","9","BIKE","10.74","5500","0","5500","89","Dirja Mansur","L"
"2018","9","FOOD","6.6","8000","77000","85000","89","Dirja Mansur","L"
"2018","9","CAR","9.76","19200","0","19200","109","Maimunah Pudjiastuti","P"
"2018","9","BIKE","10.91","5500","0","5500","102","Intan Nasyiah","P"
"2018","9","SHOP","7.54","10000","98500","108500","92","Danu Januar","L"
"2018","9","CAR","3.49","4800","0","4800","108","Ana Maimunah Pertiwi S.H.","P"
"2018","9","BIKE","6.05","3000","0","3000","78","Maryadi Natsir","L"
"2018","9","BIKE","5.14","2500","0","2500","82","Latif Marbun","L"
"2018","9","CAR","7.13","13200","0","13200","107","Gasti Nadia Pratiwi S.Gz","P"
"2018","9","BIKE","11.17","5500","0","5500","88","Jatmiko Waluyo S.Pd","L"
"2018","9","BIKE","8.61","4000","0","4000","88","Jatmiko Waluyo S.Pd","L"
"2018","9","FOOD","7.79","10000","35000","45000","104","Faizah Shania Usamah S.T.","P"
"2018","9","CAR","8","15600","0","15600","95","Cengkal Marpaung","L"
"2018","9","SHOP","4.69","6000","41000","47000","80","Mursita Prasetya","L"
"2018","9","BIKE","17.92","9500","0","9500","84","Lukita Napitupulu","L"
"2018","9","BIKE","10.96","5500","0","5500","101","Kartika Winarsih S.Ked","P"
"2018","9","FOOD","5.38","7000","50500","57500","94","Harjo Karya Suwarno","L"
"2018","9","BIKE","9.98","5000","0","5000","84","Lukita Napitupulu","L"
"2018","9","BIKE","10.69","5500","0","5500","101","Kartika Winarsih S.Ked","P"
"2018","9","FOOD","7.73","10000","57000","67000","75","Atma Dasa Uwais","L"
"2018","9","CAR","6.42","12000","0","12000","107","Gasti Nadia Pratiwi S.Gz","P"
"2018","9","FOOD","8.64","11000","99500","110500","86","Daliono Firgantoro","L"
"2018","9","BIKE","8.1","4000","0","4000","84","Lukita Napitupulu","L"
"2018","9","BIKE","9.75","5000","0","5000","77","Lukman Ganep Januar M.Ak","L"
"2018","9","FOOD","7.91","10000","35000","45000","81","Manah Sirait","L"
"2018","9","FOOD","7.26","9000","59000","68000","93","Mahesa Tarihoran S.Farm","L"
"2018","9","BIKE","7.5","3500","0","3500","80","Mursita Prasetya","L"
"2018","9","FOOD","7.48","10000","62500","72500","102","Intan Nasyiah","P"
